#########################
#                       #
#                  E    #
#                ####   #
#                       #
#             B         #
#            ####       #
#                       #
#          B            #
#        ####           #
#                       #
#      B                #
#    ####               #
#                       #
#  B                    #
#####                   #
#                       #
#@  P                   #
#########################